


AD                    EBBBBBBBBBBBBBF
AD                    CAAAAAAAAAAAAAD
AD                    CAAAAAAAAAAAAAH
AD                    CAAAAAAAAAAAAAA
AD                    CAAAAAAAAAAAAAA
AD                    CAAAAAAAAAAAAAA
AD                    CAAAAAAAAAAAAAA
AD                    CAAAAAAAAAAAAAA
AHBBBBBBBBBBBBBBGAAAAAAAAAAAAAAAHBBBB